********************************
*                              *
*       ***********   *        *
*       *         *   *    *   *
* ****  *****  ****   *    *   *
*                 ****     *   *
*                 * E*     *   *
***************   *  *     *   *
*                 *  *     *   *
* ************    *  **    ***** 
*                 *            *
*********S ***    ******      **
********************************